11111111111111-
00001100001100-
01101101101101-
01101101101101-
01101101101101-
01101101101101-
01101101101101-
01101101101101-
01101101101101-
01100001100001
